                                                                
  +----------+                                                  
  |..........|                                                  
  |..........|                                                  
  |..........|                +-------+                         
  |..........|                |.......|                         
  |..........|                |.......+---+                     
  |..........|   ##############...........|                     
  |..........|   #            |...........+---+                 
  |..........----#---+        |...............|                 
  |..................|        |...............####              
  |..................|        |...............|  #              
  |..................|        |-----#-----#---|  #              
  |..................|              #     #      #              
  |..................|              #######      #              
  +--------#---------+                           ##########     
           ######                                    #          
             #                                +------#------+   
             #                                |.............|   
        +----#------------+                 +-+.............+-+ 
        |.................|                 |.................| 
        |.................|               +-+.............+---+ 
        |.................|               |...............|     
        +------+..........|           +---+...............+----+
               |..........|           |........................|
             +-+..........+-----------+........................|
             |.................................................|
             +------------------#------------------------------+
                                #                               
                                #       #                       
                                #########                        